{
	"tileset" : "terrain.png",
	"terrain" : [
		[121 , 121 , 121 , 121 , 121 , 121 , 8 , 8 , 8 , 121 , 121 , 121 ,121 , 121 , 121],
		[121 , 121 , 121 , 121 , 121 , 121 , 8 , 8 , 8 , 121 , 121 , 121 ,121 , 121 , 121],
		[121 , 121 , 121 , 121 , 121 , 121 , 8 , 8 , 8 , 121 , 121 , 121 ,121 , 121 , 121],
		[121 , 121 , 121 , 121 , 121 , 121 , 8 , 8 , 8 , 121 , 121 , 121 ,121 , 121 , 121],
		[121 , 121 , 121 , 121 , 121 , 121 , 8 , 8 , 8 , 121 , 121 , 121 ,121 , 121 , 121],
		[121 , 121 , 121 , 121 , 121 , 121 , 8 , 8 , 8 , 121 , 121 , 121 ,121 , 121 , 121],
		[121 , 121 , 121 , 121 , 121 , 121 , 8 , 8 , 8 , 121 , 121 , 121 ,121 , 121 , 121],
		[121 , 121 , 121 , 121 , 121 , 121 , 8 , 8 , 8 , 121 , 121 , 121 ,121 , 121 , 121],
		[121 , 121 , 121 , 121 , 121 , 121 , 8 , 8 , 8 , 121 , 121 , 121 ,121 , 121 , 121],
		[121 , 121 , 121 , 121 , 121 , 121 , 8 , 8 , 8 , 121 , 121 , 121 ,121 , 121 , 121],
		[121 , 121 , 121 , 121 , 121 , 121 , 8 , 8 , 8 , 121 , 121 , 121 ,121 , 121 , 121],
		[121 , 121 , 121 , 121 , 121 , 121 , 8 , 8 , 8 , 121 , 121 , 121 ,121 , 121 , 121],
		[121 , 121 , 121 , 121 , 121 , 121 , 8 , 8 , 8 , 121 , 121 , 121 ,121 , 121 , 121],
		[121 , 121 , 121 , 121 , 121 , 121 , 8 , 8 , 8 , 121 , 121 , 121 ,121 , 121 , 121],
		[121 , 121 , 121 , 121 , 121 , 121 , 8 , 8 , 8 , 121 , 121 , 121 ,121 , 121 , 121]
	],
	"walkable" : [
		[0 , 0 , 0 , 0 , 0 , 0 , 1 , 1 , 1 , 0 , 0 , 0 , 0 , 0 , 0],
		[0 , 0 , 0 , 0 , 0 , 0 , 1 , 1 , 1 , 0 , 0 , 0 , 0 , 0 , 0],
		[0 , 0 , 0 , 0 , 0 , 0 , 1 , 1 , 1 , 0 , 0 , 0 , 0 , 0 , 0],
		[0 , 0 , 0 , 0 , 0 , 0 , 1 , 1 , 1 , 0 , 0 , 0 , 0 , 0 , 0],
		[0 , 0 , 0 , 0 , 0 , 0 , 1 , 1 , 1 , 0 , 0 , 0 , 0 , 0 , 0],
		[0 , 0 , 0 , 0 , 0 , 0 , 1 , 1 , 1 , 0 , 0 , 0 , 0 , 0 , 0],
		[0 , 0 , 0 , 0 , 0 , 0 , 1 , 1 , 1 , 0 , 0 , 0 , 0 , 0 , 0],
		[0 , 0 , 0 , 0 , 0 , 0 , 1 , 1 , 1 , 0 , 0 , 0 , 0 , 0 , 0],
		[0 , 0 , 0 , 0 , 0 , 0 , 1 , 1 , 1 , 0 , 0 , 0 , 0 , 0 , 0],
		[0 , 0 , 0 , 0 , 0 , 0 , 1 , 1 , 1 , 0 , 0 , 0 , 0 , 0 , 0],
		[0 , 0 , 0 , 0 , 0 , 0 , 1 , 1 , 1 , 0 , 0 , 0 , 0 , 0 , 0],
		[0 , 0 , 0 , 0 , 0 , 0 , 1 , 1 , 1 , 0 , 0 , 0 , 0 , 0 , 0],
		[0 , 0 , 0 , 0 , 0 , 0 , 1 , 1 , 1 , 0 , 0 , 0 , 0 , 0 , 0],
		[0 , 0 , 0 , 0 , 0 , 0 , 1 , 1 , 1 , 0 , 0 , 0 , 0 , 0 , 0],
		[0 , 0 , 0 , 0 , 0 , 0 , 1 , 1 , 1 , 0 , 0 , 0 , 0 , 0 , 0]
	]
}
