{
	"tileset" : "chemin.png",
	"terrain" : [
		[2 , 2 , 2 , 2 , 2 , 2 , 9 , 10, 11, 2 , 2 , 2 , 2 , 2 , 2],
		[2 , 2 , 2 , 2 , 2 , 2 , 9 , 10, 11, 2 , 2 , 2 , 2 , 2 , 2],
		[2 , 2 , 2 , 2 , 2 , 2 , 9 , 10, 11, 2 , 2 , 2 , 2 , 2 , 2],
		[2 , 2 , 2 , 2 , 2 , 2 , 9 , 10, 11, 2 , 2 , 2 , 2 , 2 , 2],
		[2 , 2 , 2 , 2 , 2 , 2 , 9 , 10, 11, 2 , 2 , 2 , 2 , 2 , 2],
		[2 , 2 , 2 , 2 , 2 , 2 , 9 , 10, 11, 2 , 2 , 2 , 2 , 2 , 2],
		[6 , 6 , 6 , 6 , 6 , 6 , 8 , 10, 10 , 6 , 6 , 6 , 6 , 6 , 6],
		[10, 10, 10, 10, 10, 10, 10, 10, 10, 10,10, 10, 10, 10, 10],
		[14, 14, 14, 14, 14, 14, 12, 10, 12, 14,14, 14, 14, 14, 14],
		[2 , 2 , 2 , 2 , 2 , 2 , 9 , 10, 11, 2 , 2 , 2 , 2 , 2 , 2],
		[2 , 2 , 2 , 2 , 2 , 2 , 9 , 10, 11, 2 , 2 , 2 , 2 , 2 , 2],
		[2 , 2 , 2 , 2 , 2 , 2 , 9 , 10, 11, 2 , 2 , 2 , 2 , 2 , 2],
		[2 , 2 , 2 , 2 , 2 , 2 , 9 , 10, 11, 2 , 2 , 2 , 2 , 2 , 2],
		[2 , 2 , 2 , 2 , 2 , 2 , 9 , 10, 11, 2 , 2 , 2 , 2 , 2 , 2],
		[2 , 2 , 2 , 2 , 2 , 2 , 9 , 10, 11, 2 , 2 , 2 , 2 , 2 , 2]
	],
	"walkable" : [
		[1 , 1 , 1 , 1 , 1 , 0 , 1 , 1 , 1 , 0 , 1 , 1 , 1 , 1 , 1],
		[1 , 1 , 1 , 1 , 1 , 0 , 1 , 1 , 1 , 0 , 1 , 1 , 1 , 1 , 1],
		[1 , 1 , 1 , 1 , 1 , 0 , 1 , 1 , 1 , 0 , 1 , 1 , 1 , 1 , 1],
		[1 , 1 , 1 , 1 , 1 , 0 , 1 , 1 , 1 , 0 , 1 , 1 , 1 , 1 , 1],
		[1 , 1 , 1 , 1 , 1 , 0 , 1 , 1 , 1 , 0 , 1 , 1 , 1 , 1 , 1],
		[0 , 0 , 0 , 0 , 0 , 0 , 1 , 1 , 1 , 0 , 0 , 0 , 0 , 0 , 0],
		[1 , 1 , 1 , 1 , 1 , 1 , 1 , 1 , 1 , 1 , 1 , 1 , 1 , 1 , 1],
		[1 , 1 , 1 , 1 , 1 , 1 , 1 , 1 , 1 , 1 , 1 , 1 , 1 , 1 , 1],
		[1 , 1 , 1 , 1 , 1 , 1 , 1 , 1 , 1 , 1 , 1 , 1 , 1 , 1 , 1],
		[0 , 0 , 0 , 0 , 0 , 0 , 1 , 1 , 1 , 0 , 0 , 0 , 0 , 0 , 0],
		[1 , 1 , 1 , 1 , 1 , 0 , 1 , 1 , 1 , 0 , 1 , 1 , 1 , 1 , 1],
		[1 , 1 , 1 , 1 , 1 , 0 , 1 , 1 , 1 , 0 , 1 , 1 , 1 , 1 , 1],
		[0 , 0 , 1 , 1 , 1 , 0 , 1 , 1 , 1 , 0 , 1 , 1 , 1 , 1 , 1],
		[1 , 0 , 1 , 1 , 1 , 0 , 1 , 1 , 1 , 0 , 1 , 1 , 1 , 1 , 1],
		[1 , 0 , 1 , 1 , 1 , 0 , 1 , 1 , 1 , 0 , 1 , 1 , 1 , 1 , 1]
	]
}
